111111111111111111111
1000C00000C000C000C01
10C010C0G010C010C0101
1010C01000C010C010C01
10C010C00010C010C0101
1010C010E0C010C010C01
10C010C00010C010C0101
1010C01000C010C010C01
10C010C0P010C010C0101
1000C00000C000C000C01
111111111111111111111
